9	9	9	9	9	9	9	9	9	9	9	9	9	9	9	9	9	9	9	9	9	9	9	9	9	9	9	9	9	9	9	9	9	9	9	9	9	9	9	9
9	0	0	0	0	0	0	0	0	0	0	0	0	1	0	0	0	1	2	3	3	2	1	0	0	0	1	0	0	0	0	0	0	0	0	0	0	0	0	9
9	0	0	0	0	0	0	0	0	0	0	0	1	2	1	0	0	9	9	9	9	9	9	0	0	1	2	1	0	0	0	0	0	0	0	0	0	0	0	9
9	0	0	1	0	9	0	1	2	0	0	0	0	1	2	1	0	0	0	0	0	0	0	0	1	2	1	0	0	0	0	2	1	0	9	0	1	0	0	9
9	0	0	0	3	9	0	2	1	0	9	0	0	0	1	0	0	0	0	0	0	0	0	0	0	1	0	0	0	9	0	1	2	0	9	3	0	0	0	9
9	0	0	9	9	9	0	0	0	0	9	3	0	0	0	0	0	0	0	0	0	0	0	0	0	0	0	0	3	9	0	0	0	0	9	9	9	0	0	9
9	0	0	0	0	0	0	0	0	0	9	9	9	0	0	0	0	0	0	0	0	0	0	0	0	0	0	9	9	9	0	0	0	0	0	0	0	0	0	9
9	1	0	0	0	0	0	0	0	0	0	0	0	0	0	0	9	0	0	0	0	0	0	9	0	0	0	0	0	0	0	0	0	0	0	0	0	0	1	9
9	0	1	0	0	0	0	0	0	0	0	0	0	0	0	3	9	1	2	9	9	2	1	9	3	0	0	0	0	0	0	0	0	0	0	0	0	1	0	9
9	1	0	0	0	9	9	9	0	0	0	0	0	0	9	9	9	2	1	9	9	1	2	9	9	9	0	0	0	0	0	0	9	9	9	0	0	0	1	9
9	0	0	0	0	1	3	9	1	0	0	0	0	0	0	0	0	0	0	0	0	0	0	0	0	0	0	0	0	0	0	1	9	3	1	0	0	0	0	9
9	0	0	0	0	0	1	9	2	0	0	0	0	0	0	0	0	0	0	0	0	0	0	0	0	0	0	0	0	0	0	2	9	1	0	0	0	0	0	9
9	0	0	0	0	0	0	0	1	9	9	9	0	0	0	0	0	0	0	0	0	0	0	0	0	0	0	0	9	9	9	1	0	0	0	0	0	0	0	9
9	0	0	0	0	0	0	0	0	9	3	0	0	0	9	9	9	0	0	2	2	0	0	9	9	9	0	0	0	3	9	0	0	0	0	0	0	0	0	9
9	1	1	9	2	0	0	0	0	9	0	0	0	0	0	3	9	0	2	2	2	2	0	9	3	0	0	0	0	0	9	0	0	0	0	2	9	1	1	9
9	1	1	9	3	2	0	0	0	0	0	0	2	0	0	0	9	0	9	9	9	9	0	9	0	0	0	2	0	0	0	0	0	0	2	3	9	1	1	9
9	1	1	9	9	9	0	0	0	0	0	2	3	2	0	0	2	0	0	0	0	0	0	2	0	0	2	3	2	0	0	0	0	0	9	9	9	1	1	9
9	0	0	0	0	0	0	0	0	0	0	2	3	2	0	0	2	0	0	0	0	0	0	2	0	0	2	3	2	0	0	0	0	0	0	0	0	0	0	9
9	0	0	0	0	0	0	0	9	9	9	0	2	0	0	0	9	0	3	3	3	3	0	9	0	0	0	2	0	9	9	9	0	0	0	0	0	0	0	9
9	0	0	0	0	0	0	0	1	1	1	0	0	0	0	1	9	0	3	3	3	3	0	9	1	0	0	0	0	1	1	1	0	0	0	0	0	0	0	9
9	0	0	0	0	0	0	0	1	1	1	0	0	0	0	1	9	0	3	3	3	3	0	9	1	0	0	0	0	1	1	1	0	0	0	0	0	0	0	9
9	0	0	0	0	0	0	0	9	9	9	0	2	0	0	0	9	0	3	3	3	3	0	9	0	0	0	2	0	9	9	9	0	0	0	0	0	0	0	9
9	0	0	0	0	0	0	0	0	0	0	2	3	2	0	0	2	0	0	0	0	0	0	2	0	0	2	3	2	0	0	0	0	0	0	0	0	0	0	9
9	1	1	9	9	9	0	0	0	0	0	2	3	2	0	0	2	0	0	0	0	0	0	2	0	0	2	3	2	0	0	0	0	0	9	9	9	1	1	9
9	1	1	9	3	2	0	0	0	0	0	0	2	0	0	0	9	0	9	9	9	9	0	9	0	0	0	2	0	0	0	0	0	0	2	3	9	1	1	9
9	1	1	9	2	0	0	0	0	9	0	0	0	0	0	3	9	0	2	2	2	2	0	9	3	0	0	0	0	0	9	0	0	0	0	2	9	1	1	9
9	0	0	0	0	0	0	0	0	9	3	0	0	0	9	9	9	0	0	2	2	0	0	9	9	9	0	0	0	3	9	0	0	0	0	0	0	0	0	9
9	0	0	0	0	0	0	0	1	9	9	9	0	0	0	0	0	0	0	0	0	0	0	0	0	0	0	0	9	9	9	1	0	0	0	0	0	0	0	9
9	0	0	0	0	0	1	9	2	0	0	0	0	0	0	0	0	0	0	0	0	0	0	0	0	0	0	0	0	0	0	2	9	1	0	0	0	0	0	9
9	0	0	0	0	1	3	9	1	0	0	0	0	0	0	0	0	0	0	0	0	0	0	0	0	0	0	0	0	0	0	1	9	3	1	0	0	0	0	9
9	1	0	0	0	9	9	9	0	0	0	0	0	0	9	9	9	2	1	9	9	1	2	9	9	9	0	0	0	0	0	0	9	9	9	0	0	0	1	9
9	0	1	0	0	0	0	0	0	0	0	0	0	0	0	3	9	1	2	9	9	2	1	9	3	0	0	0	0	0	0	0	0	0	0	0	0	1	0	9
9	1	0	0	0	0	0	0	0	0	0	0	0	0	0	0	9	0	0	0	0	0	0	9	0	0	0	0	0	0	0	0	0	0	0	0	0	0	1	9
9	0	0	0	0	0	0	0	0	0	9	9	9	0	0	0	0	0	0	0	0	0	0	0	0	0	0	9	9	9	0	0	0	0	0	0	0	0	0	9
9	0	0	9	9	9	0	0	0	0	9	3	0	0	0	0	0	0	0	0	0	0	0	0	0	0	0	0	3	9	0	0	0	0	9	9	9	0	0	9
9	0	0	0	3	9	0	2	1	0	9	0	0	0	1	0	0	0	0	0	0	0	0	0	0	1	0	0	0	9	0	1	2	0	9	3	0	0	0	9
9	0	0	1	0	9	0	1	2	0	0	0	0	1	2	1	0	0	0	0	0	0	0	0	1	2	1	0	0	0	0	2	1	0	9	0	1	0	0	9
9	0	0	0	0	0	0	0	0	0	0	0	1	2	1	0	0	9	9	9	9	9	9	0	0	1	2	1	0	0	0	0	0	0	0	0	0	0	0	9
9	0	0	0	0	0	0	0	0	0	0	0	0	1	0	0	0	1	2	3	3	2	1	0	0	0	1	0	0	0	0	0	0	0	0	0	0	0	0	9
9	9	9	9	9	9	9	9	9	9	9	9	9	9	9	9	9	9	9	9	9	9	9	9	9	9	9	9	9	9	9	9	9	9	9	9	9	9	9	9